ref_month,first,second,third,n_vintages,rev_2nd_minus_1st,rev_3rd_minus_1st,pct_rev_3rd_vs_3rd,USREC
1939-01-01,29770,29770,29765,16,0,-5,-0.016798252981689903,0
1939-02-01,29916,29916,29912,18,0,-4,-0.013372559507889811,0
1939-03-01,30163,30163,30159,16,0,-4,-0.013263039225438509,0
1939-04-01,29954,29954,29950,15,0,-4,-0.01335559265442404,0
1939-05-01,30191,30191,30186,17,0,-5,-0.016563970052342145,0
1939-06-01,30439,30439,30435,16,0,-4,-0.013142763265976671,0
1939-07-01,30477,30477,30473,15,0,-4,-0.013126374167295639,0
1939-08-01,30685,30685,30682,17,0,-3,-0.009777719835734307,0
1939-09-01,31129,31129,31125,17,0,-4,-0.01285140562248996,0
1939-10-01,31482,31482,31477,17,0,-5,-0.015884614162721987,0
1939-11-01,31521,31521,31517,17,0,-4,-0.012691563283307422,0
1939-12-01,31540,31540,31531,17,0,-9,-0.02854333830198852,0
1940-01-01,31449,31449,31445,16,0,-4,-0.012720623310542217,0
1940-02-01,31538,31538,31533,16,0,-5,-0.015856404401737863,0
1940-03-01,31637,31637,31634,17,0,-3,-0.009483467155592085,0
1940-04-01,31630,31630,31625,18,0,-5,-0.015810276679841896,0
1940-05-01,31783,31783,31778,17,0,-5,-0.01573415570520486,0
1940-06-01,31928,31928,31924,17,0,-4,-0.01252975817566721,0
1940-07-01,32011,32011,32007,15,0,-4,-0.012497266223013715,0
1940-08-01,32390,32390,32387,16,0,-3,-0.009262975885386111,0
1940-09-01,32870,32870,32867,16,0,-3,-0.009127696473666595,0
1940-10-01,33270,33270,33268,17,0,-2,-0.006011783094865937,0
1940-11-01,33648,33648,33646,17,0,-2,-0.005944243000653867,0
1940-12-01,34138,34138,34125,17,0,-13,-0.0380952380952381,0
1941-01-01,34402,34402,34399,17,0,-3,-0.008721183755341725,0
1941-02-01,34746,34746,34743,17,0,-3,-0.008634832915983076,0
1941-03-01,35027,35027,35022,17,0,-5,-0.014276740334646794,0
1941-04-01,35316,35316,35311,18,0,-5,-0.014159893517600749,0
1941-05-01,36090,36090,36085,16,0,-5,-0.013856172925038105,0
1941-06-01,36584,36584,36578,17,0,-6,-0.016403302531576357,0
1941-07-01,37183,37183,37176,16,0,-7,-0.0188293522702819,0
1941-08-01,37561,37561,37554,16,0,-7,-0.018639825318208448,0
1941-09-01,37820,37820,37813,17,0,-7,-0.01851215190542935,0
1941-10-01,37857,37857,37852,17,0,-5,-0.013209341646412343,0
1941-11-01,37919,37919,37916,16,0,-3,-0.007912227028167528,0
1941-12-01,38018,38018,38031,16,0,13,0.034182640477505195,0
1942-01-01,38266,38266,38261,17,0,-5,-0.01306813726771386,0
1942-02-01,38434,38434,38427,17,0,-7,-0.01821635828974419,0
1942-03-01,38825,38825,38817,17,0,-8,-0.020609526753741916,0
1942-04-01,39285,39285,39275,17,0,-10,-0.025461489497135583,0
1942-05-01,39646,39646,39636,17,0,-10,-0.02522958926228681,0
1942-06-01,39884,39884,39876,17,0,-8,-0.020062192797672785,0
1942-07-01,40361,40361,40348,18,0,-13,-0.032219688708238325,0
1942-08-01,40890,40890,40880,16,0,-10,-0.02446183953033268,0
1942-09-01,41125,41125,41115,18,0,-10,-0.024322023592362886,0
1942-10-01,41356,41356,41346,17,0,-10,-0.024186136506554445,0
1942-11-01,41543,41543,41532,17,0,-11,-0.026485601463931426,0
1942-12-01,41780,41780,41840,16,0,60,0.14340344168260039,0
1943-01-01,42085,42085,42073,17,0,-12,-0.02852185487129513,0
1943-02-01,42292,42292,42277,17,0,-15,-0.035480284788419233,0
1943-03-01,42478,42478,42464,17,0,-14,-0.03296910324039186,0
1943-04-01,42497,42497,42482,17,0,-15,-0.0353090720775858,0
1943-05-01,42424,42424,42406,16,0,-18,-0.04244682356270339,0
1943-06-01,42578,42578,42561,16,0,-17,-0.03994267051995959,0
1943-07-01,42459,42459,42438,15,0,-21,-0.049483953060935955,0
1943-08-01,42459,42459,42442,16,0,-17,-0.040054662833985205,0
1943-09-01,42400,42400,42385,18,0,-15,-0.035389878494750504,0
1943-10-01,42668,42668,42654,16,0,-14,-0.03282224410371829,0
1943-11-01,42714,42714,42699,18,0,-15,-0.03512962832853228,0
1943-12-01,42683,42683,42638,17,0,-45,-0.10553965945869881,0
1944-01-01,42523,42523,42509,18,0,-14,-0.03293420216895246,0
1944-02-01,42417,42417,42402,18,0,-15,-0.03537568982595161,0
1944-03-01,42231,42231,42214,18,0,-17,-0.04027100014213294,0
1944-04-01,41883,41883,41866,17,0,-17,-0.04060574212965175,0
1944-05-01,41808,41808,41788,15,0,-20,-0.04786062984588877,0
1944-06-01,41770,41770,41750,16,0,-20,-0.04790419161676647,0
1944-07-01,41670,41670,41644,18,0,-26,-0.06243396407645759,0
1944-08-01,41712,41712,41692,17,0,-20,-0.04797083373309028,0
1944-09-01,41589,41589,41568,18,0,-21,-0.050519630484988455,0
1944-10-01,41690,41690,41669,18,0,-21,-0.05039717775804555,0
1944-11-01,41617,41617,41598,18,0,-19,-0.04567527284965623,0
1944-12-01,41812,41812,41766,17,0,-46,-0.11013743236125077,0
1945-01-01,41796,41796,41769,18,0,-27,-0.06464124111182935,0
1945-02-01,41787,41787,41761,18,0,-26,-0.06225904552094059,0
1945-03-01,41743,41743,41718,18,0,-25,-0.05992617095738051,1
1945-04-01,41339,41339,41312,17,0,-27,-0.06535631293570875,1
1945-05-01,41148,41148,41122,16,0,-26,-0.06322649676572151,1
1945-06-01,40937,40937,40908,17,0,-29,-0.07089077930967048,1
1945-07-01,40647,40647,40620,17,0,-27,-0.06646971935007386,1
1945-08-01,40337,40337,40310,18,0,-27,-0.06698089804018854,1
1945-09-01,38435,38435,38409,17,0,-26,-0.06769246791116665,1
1945-10-01,38519,38519,38492,18,0,-27,-0.07014444559908553,1
1945-11-01,38864,38864,38838,18,0,-26,-0.06694474483753025,0
1945-12-01,39058,39058,39075,18,0,17,0.04350607805502239,0
1946-01-01,39757,39757,39709,18,0,-48,-0.12087939761766854,0
1946-02-01,39236,39236,39191,18,0,-45,-0.11482228062565385,0
1946-03-01,40309,40309,40267,18,0,-42,-0.10430377231976556,0
1946-04-01,40867,40867,40830,18,0,-37,-0.09061964241978937,0
1946-05-01,41290,41290,41253,17,0,-37,-0.08969044675538748,0
1946-06-01,41619,41619,41582,18,0,-37,-0.08898080900389592,0
1946-07-01,42002,42002,41968,15,0,-34,-0.08101410598551277,0
1946-08-01,42511,42511,42479,18,0,-32,-0.0753313401916241,0
1946-09-01,42837,42837,42807,18,0,-30,-0.07008199593524424,0
1946-10-01,43060,43060,43031,17,0,-29,-0.06739327461597452,0
1946-11-01,43305,43305,43278,18,0,-27,-0.062387356162484406,0
1946-12-01,43404,43404,43364,16,0,-40,-0.09224241306152568,0
1947-01-01,43531,43531,43485,18,0,-46,-0.10578360354145107,0
1947-02-01,43620,43620,43578,17,0,-42,-0.09637890678782872,0
1947-03-01,43723,43723,43685,18,0,-38,-0.08698637976422113,0
1947-04-01,43487,43487,43452,18,0,-35,-0.0805486513854368,0
1947-05-01,43588,43588,43555,17,0,-33,-0.07576627252898634,0
1947-06-01,43731,43731,43699,17,0,-32,-0.0732282203254079,0
1947-07-01,43706,43706,43675,17,0,-31,-0.07097882083571837,0
1947-08-01,43879,43879,43849,18,0,-30,-0.06841661155328514,0
1947-09-01,44082,44082,44054,17,0,-28,-0.06355836019430698,0
1947-10-01,44315,44315,44289,17,0,-26,-0.0587053218632166,0
1947-11-01,44392,44392,44365,18,0,-27,-0.06085878507832751,0
1947-12-01,44619,44619,44574,18,0,-45,-0.10095571409341769,0
1948-01-01,44698,44698,44663,18,0,-35,-0.07836464187358663,0
1948-02-01,44577,44577,44542,17,0,-35,-0.07857752233846707,0
1948-03-01,44658,44658,44627,18,0,-31,-0.06946467385215228,0
1948-04-01,44399,44399,44370,18,0,-29,-0.06535947712418301,0
1948-05-01,44687,44687,44657,17,0,-30,-0.06717871778220659,0
1948-06-01,44975,44975,44945,18,0,-30,-0.06674824785849372,0
1948-07-01,45177,45177,45146,16,0,-31,-0.06866610552429894,0
1948-08-01,45059,45059,45029,18,0,-30,-0.0666237313731151,0
1948-09-01,45160,45160,45131,18,0,-29,-0.06425738405973722,0
1948-10-01,45124,45124,45095,18,0,-29,-0.06430868167202572,0
1948-11-01,45138,45138,45109,17,0,-29,-0.06428872287126737,0
1948-12-01,45080,45080,45059,18,0,-21,-0.046605561597017245,1
1949-01-01,44679,44679,44636,18,0,-43,-0.09633479702482302,1
1949-02-01,44507,44507,44466,17,0,-41,-0.0922052804389871,1
1949-03-01,44290,44290,44253,17,0,-37,-0.08361015072424469,1
1949-04-01,44107,44107,44071,17,0,-36,-0.08168636972158562,1
1949-05-01,43887,43887,43855,17,0,-32,-0.07296773457986547,1
1949-06-01,43674,43674,43642,16,0,-32,-0.07332386233444847,1
1949-07-01,43510,43510,43479,18,0,-31,-0.07129878792060534,1
1949-08-01,43532,43532,43504,18,0,-28,-0.06436189775652813,1
1949-09-01,43681,43681,43654,17,0,-27,-0.06185000229074083,1
1949-10-01,42849,42849,42821,17,0,-28,-0.06538847761612293,1
1949-11-01,43207,43207,43180,18,0,-27,-0.06252894858730894,0
1949-12-01,43569,43569,43528,18,0,-41,-0.09419224407278073,0
1950-01-01,43519,43519,43480,18,0,-39,-0.08969641214351426,0
1950-02-01,43244,43244,43207,17,0,-37,-0.08563427222440809,0
1950-03-01,43906,43906,43869,17,0,-37,-0.08434201828170235,0
1950-04-01,44327,44327,44292,17,0,-35,-0.07902104217465908,0
1950-05-01,44649,44649,44619,17,0,-30,-0.06723593088146305,0
1950-06-01,45049,45049,45020,17,0,-29,-0.06441581519324745,0
1950-07-01,45435,45435,45405,17,0,-30,-0.06607201850016518,0
1950-08-01,46091,46091,46062,18,0,-29,-0.06295862098910164,0
1950-09-01,46311,46311,46282,17,0,-29,-0.06265934920703513,0
1950-10-01,46570,46570,46540,17,0,-30,-0.06446067898581866,0
1950-11-01,46695,46695,46665,17,0,-30,-0.06428801028608165,0
1950-12-01,46810,46810,46780,17,0,-30,-0.06412997007268063,0
1951-01-01,46766,47324,47324,18,558,558,1.1791057391598343,0
1951-02-01,46996,47568,47568,17,572,572,1.2024890682811975,0
1951-03-01,47154,47766,47766,18,612,612,1.281246074613742,0
1951-04-01,47283,47916,47916,18,633,633,1.321061858251941,0
1951-05-01,47275,47872,47872,19,597,597,1.2470755347593583,0
1951-06-01,47444,48003,48003,19,559,559,1.1645105514238694,0
1951-07-01,47471,48009,48009,19,538,538,1.1206232164802432,0
1951-08-01,47469,47855,47855,19,386,386,0.8066032807439139,0
1951-09-01,47412,47791,47791,18,379,379,0.793036345755477,0
1951-10-01,47522,47855,47855,18,333,333,0.6958520530770035,0
1951-11-01,47629,48094,48094,19,465,465,0.9668565725454319,0
1951-12-01,47700,48231,48231,19,531,531,1.100951670087703,0
1952-01-01,47714,48318,48318,19,604,604,1.2500517405521752,0
1952-02-01,47891,48502,48502,17,611,611,1.2597418663147912,0
1952-03-01,47922,48521,48521,17,599,599,1.234517013251994,0
1952-04-01,47881,48520,48520,18,639,639,1.3169826875515251,0
1952-05-01,47955,48561,48561,18,606,606,1.2479149935133131,0
1952-06-01,47662,48212,48212,18,550,550,1.1407948228656766,0
1952-07-01,47532,48042,48042,18,510,510,1.0615711252653928,0
1952-08-01,48340,48753,48753,19,413,413,0.8471273562652555,0
1952-09-01,48726,49199,49199,18,473,473,0.9614016545051729,0
1952-10-01,49085,49499,49499,18,414,414,0.8363805329400594,0
1952-11-01,49325,49760,49760,17,435,435,0.8741961414790996,0
1952-12-01,49520,50074,50074,18,554,554,1.1063625833766026,0
1953-01-01,49523,49527,49604,20,4,81,0.1632932827997742,0
1953-02-01,49647,49680,49706,19,33,59,0.11869794391019192,0
1953-03-01,49741,49735,49795,21,-6,54,0.10844462295411186,0
1953-04-01,49751,49752,49835,20,1,84,0.16855623557740543,0
1953-05-01,49822,49851,49826,20,29,4,0.008027937221530928,0
1953-06-01,49926,49935,49894,20,9,-32,-0.06413596825269571,0
1953-07-01,49949,49947,49889,19,-2,-60,-0.12026699272384694,0
1953-08-01,49884,49867,49842,20,-17,-42,-0.08426628144938005,1
1953-09-01,49743,49720,49695,20,-23,-48,-0.09658919408391187,1
1953-10-01,49715,49681,49636,20,-34,-79,-0.15915867515512935,1
1953-11-01,49415,49380,49344,21,-35,-71,-0.14388780804150453,1
1953-12-01,49096,49149,49156,20,53,60,0.12206037920091138,1
1954-01-01,48786,48791,48859,23,5,73,0.14940952536891872,1
1954-02-01,48618,48650,48714,22,32,96,0.19706860450794433,1
1954-03-01,48450,48445,48506,22,-5,56,0.11544963509668907,1
1954-04-01,48267,48268,48407,23,1,140,0.28921436982254634,1
1954-05-01,48183,48211,48271,21,28,88,0.18230407491040168,1
1954-06-01,48170,48179,48274,22,9,104,0.21543688113684384,0
1954-07-01,48048,48046,48140,21,-2,92,0.19110926464478603,0
1954-08-01,48029,48012,48149,22,-17,120,0.24922635984132588,0
1954-09-01,48020,47998,48197,23,-22,177,0.3672427744465423,0
1954-10-01,48129,48097,48348,21,-32,219,0.45296599652519237,0
1954-11-01,48386,48351,48600,23,-35,214,0.4403292181069959,0
1954-12-01,48380,48432,48756,21,52,376,0.771187135942243,0
1955-01-01,48398,48404,48820,23,6,422,0.8643998361327325,0
1955-02-01,48440,48470,48906,21,30,466,0.9528483212693739,0
1955-03-01,48762,48766,48760,24,4,-2,-0.004101722723543888,0
1955-04-01,48849,48878,48881,26,29,32,0.06546510914261165,0
1955-05-01,49184,49214,49242,24,30,58,0.11778563015312132,0
1955-06-01,49330,49483,49505,25,153,175,0.3534996465003535,0
1955-07-01,49684,49654,49640,26,-30,-44,-0.088638195004029,0
1955-08-01,49678,49750,49742,27,72,64,0.12866390575368902,0
1955-09-01,49821,49847,49857,26,26,36,0.07220651062037427,0
1955-10-01,49907,49969,49982,26,62,75,0.15005401944700092,0
1955-11-01,50149,50181,50135,24,32,-14,-0.02792460357036003,0
1955-12-01,50031,50211,50228,24,180,197,0.3922115154893685,0
1956-01-01,50208,50293,50287,25,85,79,0.15709825601049973,0
1956-02-01,50179,50280,50292,24,101,113,0.22468782311301996,0
1956-03-01,50211,50210,51057,24,-1,846,1.6569716199541689,0
1956-04-01,50377,51281,51327,23,904,950,1.8508777056909618,0
1956-05-01,51256,51389,51459,23,133,203,0.3944888163392215,0
1956-06-01,51437,51623,51600,26,186,163,0.31589147286821706,0
1956-07-01,51126,51022,51003,26,-104,-123,-0.2411622845714958,0
1956-08-01,51621,51707,51702,27,86,81,0.15666705349889753,0
1956-09-01,51555,51603,51676,27,48,121,0.23415125009675672,0
1956-10-01,51817,51869,51902,26,52,85,0.16377018226657933,0
1956-11-01,51886,51943,51950,26,57,64,0.12319538017324351,0
1956-12-01,51988,52071,52072,26,83,84,0.16131510216623138,0
1957-01-01,52112,52063,52046,25,-49,-66,-0.12681089805172346,0
1957-02-01,52151,52105,52108,26,-46,-43,-0.08252091809319106,0
1957-03-01,52008,52063,52522,27,55,514,0.9786375233235597,0
1957-04-01,51992,52567,52568,25,575,576,1.0957236341500534,0
1957-05-01,52569,52639,52672,26,70,103,0.1955498177399757,0
1957-06-01,52615,52762,52773,26,147,158,0.29939552422640364,0
1957-07-01,52786,52809,52815,25,23,29,0.05490864337782827,0
1957-08-01,52788,52870,52844,27,82,56,0.10597229581409431,0
1957-09-01,52682,52644,52662,26,-38,-20,-0.037978048687858416,1
1957-10-01,52507,52486,52469,26,-21,-38,-0.07242371686138482,1
1957-11-01,52189,52237,52218,27,48,29,0.055536405071048296,1
1957-12-01,51895,51930,51980,25,35,85,0.16352443247402848,1
1958-01-01,51735,51756,51709,28,21,-26,-0.0502813823512348,1
1958-02-01,51151,51035,51055,27,-116,-96,-0.18803251395553813,1
1958-03-01,50732,50739,50719,26,7,-13,-0.025631420177842625,1
1958-04-01,50579,50585,50054,26,6,-525,-1.0488672233987293,1
1958-05-01,50700,50144,50147,25,-556,-553,-1.1027578917981136,0
1958-06-01,50289,50297,50315,27,8,26,0.05167445095895856,0
1958-07-01,50428,50431,50411,25,3,-17,-0.033722798595544626,0
1958-08-01,50529,50552,50570,28,23,41,0.08107573660272889,0
1958-09-01,50651,50779,50780,26,128,129,0.2540370224497834,0
1958-10-01,50660,50586,50582,28,-74,-78,-0.15420505318097347,0
1958-11-01,50773,50825,50877,26,52,104,0.20441456846905282,0
1958-12-01,50736,50818,50844,27,82,108,0.2124144441822044,0
1959-01-01,50992,51022,51039,29,30,47,0.09208644369991575,0
1959-02-01,51036,51113,51117,28,77,81,0.1584600035213334,0
1959-03-01,51357,51394,51456,27,37,99,0.1923973880597015,0
1959-04-01,51763,51869,51887,25,106,124,0.23898086225836915,0
1959-05-01,52100,52127,52125,26,27,25,0.047961630695443645,0
1959-06-01,52345,52408,52407,26,63,62,0.11830480660980404,0
1959-07-01,52572,52585,52558,27,13,-14,-0.026637238859926176,0
1959-08-01,52407,52011,52023,27,-396,-384,-0.7381350556484632,0
1959-09-01,51999,52169,52154,28,170,155,0.2971967634313763,0
1959-10-01,52006,51996,52002,27,-10,-4,-0.007692011845698243,0
1959-11-01,52120,52199,52253,26,79,133,0.2545308403345262,0
1959-12-01,52485,52654,52674,26,169,189,0.3588107984964119,0
1960-01-01,52800,52881,52880,26,81,80,0.15128593040847202,0
1960-02-01,52928,52950,52972,26,22,44,0.08306275013214529,0
1960-03-01,52736,52803,52823,27,67,87,0.16470098252655094,0
1960-04-01,53044,53109,53128,27,65,84,0.15810871856648095,0
1960-05-01,53042,53095,53105,28,53,63,0.11863289709066943,1
1960-06-01,53039,53114,53140,27,75,101,0.1900639819345126,1
1960-07-01,53133,53158,53145,27,25,12,0.022579734688117414,1
1960-08-01,53076,53036,53046,26,-40,-30,-0.05655468838366701,1
1960-09-01,52994,52952,52998,26,-42,4,0.0075474546209290914,1
1960-10-01,52854,52806,52809,26,-48,-45,-0.08521274782707493,1
1960-11-01,52704,52588,52591,26,-116,-113,-0.21486566142495864,1
1960-12-01,52224,52215,52221,28,-9,-3,-0.00574481530418797,1
1961-01-01,52342,52273,52232,27,-69,-110,-0.2105988665951907,1
1961-02-01,51996,51981,51984,28,-15,-12,-0.023084025854108958,1
1961-03-01,52005,51841,51939,28,-164,-66,-0.12707214232079939,0
1961-04-01,52176,52226,52243,25,50,67,0.12824684646746934,0
1961-05-01,52433,52513,52541,29,80,108,0.2055537580175482,0
1961-06-01,52829,52938,52949,27,109,120,0.22663317531964722,0
1961-07-01,53160,53078,53072,27,-82,-88,-0.1658124811576726,0
1961-08-01,53132,53143,54333,27,11,1201,2.210443008852815,0
1961-09-01,53171,54417,54304,25,1246,1133,2.0864024749558046,0
1961-10-01,54576,54420,54385,26,-156,-191,-0.35119977935092395,0
1961-11-01,54478,54517,54525,25,39,47,0.08619899128839982,0
1961-12-01,54491,54495,54492,26,4,1,0.0018351317624605446,0
1962-01-01,54434,54424,54434,23,-10,0,0.0,0
1962-02-01,54693,54778,54773,26,85,80,0.14605736402972266,0
1962-03-01,54828,54871,54901,26,43,73,0.13296661263000675,0
1962-04-01,55112,55229,55260,24,117,148,0.2678248280854144,0
1962-05-01,55291,55371,55403,24,80,112,0.20215511795390143,0
1962-06-01,55414,55508,55535,25,94,121,0.2178806158278563,0
1962-07-01,55632,55649,55617,25,17,-15,-0.02697017099088408,0
1962-08-01,55565,55556,55536,25,-9,-29,-0.052218380870066264,0
1962-09-01,55551,55582,55583,26,31,32,0.05757155964953313,0
1962-10-01,55626,55620,55647,24,-6,21,0.03773788344385142,0
1962-11-01,55589,55577,55597,25,-12,8,0.01438926560785654,0
1962-12-01,55594,55617,55580,26,23,-14,-0.02518891687657431,0
1963-01-01,55551,55552,55536,25,1,-15,-0.027009507346585998,0
1963-02-01,55734,55727,55730,25,-7,-4,-0.007177462766911897,0
1963-03-01,55928,55953,55963,26,25,35,0.06254132194485643,0
1963-04-01,56229,56189,56191,24,-40,-38,-0.06762648822765212,0
1963-05-01,56359,56413,56435,25,54,76,0.13466820235669355,0
1963-06-01,56556,56588,57194,25,32,638,1.11550162604469,0
1963-07-01,56718,57356,57340,25,638,622,1.0847575863271712,0
1963-08-01,57299,57325,57344,23,26,45,0.07847377232142858,0
1963-09-01,57427,57452,57453,26,25,26,0.04525438184254956,0
1963-10-01,57544,57622,57646,25,78,102,0.17694202546577387,0
1963-11-01,57663,57623,57580,24,-40,-83,-0.14414727335880514,0
1963-12-01,57805,57747,57748,25,-58,-57,-0.0987047170464778,0
1964-01-01,57834,57802,57850,23,-32,16,0.027657735522904063,0
1964-02-01,58082,58160,58183,26,78,101,0.17359022394857604,0
1964-03-01,58226,58268,58327,24,42,101,0.1731616575513913,0
1964-04-01,58471,58463,58502,24,-8,31,0.05298964137978189,0
1964-05-01,58503,58551,58590,23,48,87,0.148489503328213,0
1964-06-01,58665,58750,58782,25,85,117,0.19904052260896193,0
1964-07-01,58888,58929,58912,25,41,24,0.04073872895165671,0
1964-08-01,58944,58936,58955,23,-8,11,0.018658298702400135,0
1964-09-01,59039,59049,58458,22,10,-581,-0.9938759451229943,0
1964-10-01,58983,58372,58382,24,-611,-601,-1.029426878147374,0
1964-11-01,58790,58871,58878,23,81,88,0.14946159855973368,0
1964-12-01,59097,59187,59206,24,90,109,0.18410296253758066,0
1965-01-01,59280,59328,59334,23,48,54,0.09101021336838912,0
1965-02-01,59560,59677,59676,22,117,116,0.1943830015416583,0
1965-03-01,59902,59968,59992,22,66,90,0.15002000266702226,0
1965-04-01,59917,59916,59913,24,-1,-4,-0.006676347370353679,0
1965-05-01,60064,60098,60110,23,34,46,0.07652636832473798,0
1965-06-01,60306,60362,60382,23,56,76,0.12586532410320955,0
1965-07-01,60528,60589,60602,24,61,74,0.12210818124814363,0
1965-08-01,60711,60680,60685,23,-31,-26,-0.042844195435445334,0
1965-09-01,60806,60796,60756,21,-10,-50,-0.08229639870959247,0
1965-10-01,61019,60975,61001,23,-44,-18,-0.029507712988311667,0
1965-11-01,61268,61430,61472,23,162,204,0.33185840707964603,0
1965-12-01,61797,61865,61884,23,68,87,0.14058561178980028,0
1966-01-01,62111,62146,62148,22,35,37,0.05953530282551329,0
1966-02-01,62404,62488,62501,21,84,97,0.15519751683973057,0
1966-03-01,62809,62881,62918,22,72,109,0.17324136177246574,0
1966-04-01,62887,62933,62935,22,46,48,0.07626916660046079,0
1966-05-01,63099,63060,63050,22,-39,-49,-0.07771609833465504,0
1966-06-01,63384,63496,63983,22,112,599,0.936186174452589,0
1966-07-01,63646,64089,64072,19,443,426,0.6648770133599701,0
1966-08-01,64299,64196,64199,20,-103,-100,-0.1557656661318712,0
1966-09-01,64181,64159,64168,23,-22,-13,-0.02025931928687196,0
1966-10-01,64351,64428,64466,21,77,115,0.17838860794837588,0
1966-11-01,64699,64818,64823,21,119,124,0.1912901285037718,0
1966-12-01,65066,65081,65076,23,15,10,0.015366648226688795,0
1967-01-01,65360,65372,65381,21,12,21,0.03211942307398174,0
1967-02-01,65495,65463,65497,24,-32,2,0.003053574972899522,0
1967-03-01,65486,65513,65600,22,27,114,0.17378048780487804,0
1967-04-01,65611,65479,65476,22,-132,-135,-0.20618241798521594,0
1967-05-01,65435,65412,65428,23,-23,-7,-0.01069878339548817,0
1967-06-01,65565,65687,65903,21,122,338,0.5128749829294569,0
1967-07-01,65882,65947,65939,21,65,57,0.08644353114241951,0
1967-08-01,66250,66216,66190,21,-34,-60,-0.09064813415923856,0
1967-09-01,66100,66047,66055,21,-53,-45,-0.06812504730906063,0
1967-10-01,66165,66231,66243,20,66,78,0.11774829038539922,0
1967-11-01,66709,66929,66918,21,220,209,0.31232254400908577,0
1967-12-01,67128,67110,67126,21,-18,-2,-0.002979471441766231,0
1968-01-01,67146,67137,67058,23,-9,-88,-0.13122968176802172,0
1968-02-01,67694,67712,67600,22,18,-94,-0.1390532544378698,0
1968-03-01,67855,67813,67656,22,-42,-199,-0.2941350360647984,0
1968-04-01,67921,67784,67755,23,-137,-166,-0.2450003689764593,0
1968-05-01,67788,67781,67792,24,-7,4,0.0059004012272834555,0
1968-06-01,67863,67997,68039,22,134,176,0.258675171592763,0
1968-07-01,68156,68201,68170,22,45,14,0.020536893061463987,0
1968-08-01,68409,68335,68314,21,-74,-95,-0.13906373510554207,0
1968-09-01,68458,68389,68382,21,-69,-76,-0.11114035857389372,0
1968-10-01,68525,68640,68701,21,115,176,0.25618258831749174,0
1968-11-01,68803,68920,68955,22,117,152,0.2204336161264593,0
1968-12-01,69186,69280,69310,23,94,124,0.17890636271822247,0
1969-01-01,69538,69618,69620,21,80,82,0.11778224648089629,0
1969-02-01,69997,69955,69983,23,-42,-14,-0.020004858322735523,0
1969-03-01,70102,70180,70159,21,78,57,0.08124403141435882,0
1969-04-01,70214,70190,69789,20,-24,-425,-0.6089784923125421,0
1969-05-01,70282,70024,70013,19,-258,-269,-0.3842143601902504,0
1969-06-01,70216,70270,70300,19,54,84,0.11948790896159317,0
1969-07-01,70462,70269,70247,21,-193,-215,-0.30606289236551026,0
1969-08-01,70436,70405,70500,22,-31,64,0.09078014184397164,0
1969-09-01,70398,70486,70390,22,88,-8,-0.011365250745844581,0
1969-10-01,70673,70642,70651,21,-31,-22,-0.031138978924572902,0
1969-11-01,70621,70653,70635,21,32,14,0.01982020244921073,0
1969-12-01,70639,70656,70679,21,17,40,0.05659389634827884,0
1970-01-01,70649,70778,70818,21,129,169,0.2386398938123076,1
1970-02-01,70766,70990,71004,22,224,238,0.3351923835276886,1
1970-03-01,71033,71060,71256,23,27,223,0.31295610194229256,1
1970-04-01,70972,71124,71163,21,152,191,0.26839790340485925,1
1970-05-01,70855,70881,70852,22,26,-3,-0.004234178287133744,1
1970-06-01,70666,70598,70603,22,-68,-63,-0.08923133577893291,1
1970-07-01,70455,70635,70546,22,180,91,0.12899384798571145,1
1970-08-01,70543,70384,70414,22,-159,-129,-0.18320220410713778,1
1970-09-01,70380,70610,70531,22,230,151,0.21409025818434446,1
1970-10-01,70129,70216,70182,20,87,53,0.0755179390726967,1
1970-11-01,70082,70076,70085,19,-6,3,0.0042805165156595566,1
1970-12-01,70364,70264,70303,20,-100,-61,-0.08676727877899948,0
1971-01-01,70487,70609,70652,21,122,165,0.23353903640378193,0
1971-02-01,70514,70559,70590,23,45,76,0.10766397506728999,0
1971-03-01,70568,70662,70659,22,94,91,0.12878755714063317,0
1971-04-01,70719,70696,70735,21,-23,16,0.022619636672085955,0
1971-05-01,70826,70891,70885,20,65,59,0.08323340622134442,0
1971-06-01,70581,70647,70657,21,66,76,0.107561883465191,0
1971-07-01,70456,70566,70531,20,110,75,0.10633622095248897,0
1971-08-01,70552,70554,70529,22,2,-23,-0.03261069914503254,0
1971-09-01,70855,70907,70853,21,52,-2,-0.0028227456847275344,0
1971-10-01,70901,70831,70848,19,-70,-53,-0.07480803974706414,0
1971-11-01,70915,70981,71042,21,66,127,0.1787674896540075,0
1971-12-01,71104,71167,71185,20,63,81,0.11378801713844208,0
1972-01-01,71407,71603,71584,21,196,177,0.24726195797943676,0
1972-02-01,71686,71702,71729,21,16,43,0.05994785930376835,0
1972-03-01,71978,71990,72030,22,12,52,0.07219214216298764,0
1972-04-01,72172,72269,72263,22,97,91,0.1259288986064791,0
1972-05-01,72475,72540,72558,22,65,83,0.1143912456241903,0
1972-06-01,72556,72647,72630,22,91,74,0.10188627288999036,0
1972-07-01,72565,72592,72661,21,27,96,0.1321203947096792,0
1972-08-01,72871,72980,72984,22,109,113,0.15482845555190178,0
1972-09-01,73221,73232,73176,21,11,-45,-0.061495572318793046,0
1972-10-01,73535,73559,73589,21,24,54,0.07338053241652964,0
1972-11-01,73765,73868,73899,21,103,134,0.18132857007537315,0
1972-12-01,73892,74024,74026,20,132,134,0.18101748034474374,0
1973-01-01,74221,74155,74245,21,-66,24,0.03232540911845916,0
1973-02-01,74596,74713,74725,20,117,129,0.17263298762127802,0
1973-03-01,74901,74933,74914,20,32,13,0.01735323170568919,0
1973-04-01,75042,75074,75105,19,32,63,0.08388256440982625,0
1973-05-01,75222,75269,75321,20,47,99,0.13143744772374238,0
1973-06-01,75464,75432,75526,20,-32,62,0.08209093557185605,0
1973-07-01,75471,75515,75493,21,44,22,0.029141774734081305,0
1973-08-01,75807,75702,75747,19,-105,-60,-0.07921105786367777,0
1973-09-01,75892,75972,75961,19,80,69,0.09083608693935045,0
1973-10-01,76277,76275,76363,21,-2,86,0.11261998611893194,0
1973-11-01,76476,76642,76679,20,166,203,0.26474002008372566,0
1973-12-01,76677,76631,76626,20,-46,-51,-0.06655704330122934,1
1974-01-01,76372,76520,76526,20,148,154,0.20123879465802472,1
1974-02-01,76695,76773,76813,21,78,118,0.15361982997669665,1
1974-03-01,76648,76785,76804,20,137,156,0.2031144211238998,1
1974-04-01,76911,76928,76941,20,17,30,0.03899091511677779,1
1974-05-01,77110,77155,77136,20,45,26,0.03370669985480191,1
1974-06-01,77107,77073,77101,21,-34,-6,-0.007782000233460007,1
1974-07-01,76951,77100,77047,21,149,96,0.1245992705751035,1
1974-08-01,77177,77113,77203,19,-64,26,0.0336774477675738,1
1974-09-01,77146,77409,78844,20,263,1698,2.153619806199584,1
1974-10-01,77439,78811,78865,20,1372,1426,1.8081531731439802,1
1974-11-01,78368,78400,78404,20,32,36,0.04591602469261773,1
1974-12-01,77726,77733,77690,20,7,-36,-0.04633801003990218,1
1975-01-01,77295,77166,77227,20,-129,-68,-0.08805210612868557,1
1975-02-01,76558,76678,76708,19,120,150,0.19554674870939145,1
1975-03-01,76353,76346,76368,19,-7,15,0.019641734758013826,1
1975-04-01,76293,76381,76349,21,88,56,0.07334739158338681,0
1975-05-01,76443,76439,76428,19,-4,-15,-0.019626314963102527,0
1975-06-01,76464,76264,76291,21,-200,-173,-0.22676331415239018,0
1975-07-01,76352,76507,76679,20,155,327,0.4264531357998931,0
1975-08-01,77035,77029,77023,20,-6,-12,-0.015579761889305791,0
1975-09-01,77211,77275,77310,20,64,99,0.1280558789289872,0
1975-10-01,77492,77508,77555,19,16,63,0.081232673586487,0
1975-11-01,77549,77558,77574,20,9,25,0.032227292649599094,0
1975-12-01,77798,77782,77796,21,-16,-2,-0.0025708262635611087,0
1976-01-01,78140,78137,78179,21,-3,39,0.049885519129177915,0
1976-02-01,78344,78320,78368,20,-24,24,0.030624744793793384,0
1976-03-01,78511,78545,78630,21,34,119,0.15134172707617957,0
1976-04-01,78888,78942,78963,20,54,75,0.09498119372364272,0
1976-05-01,78999,78964,78923,20,-35,-76,-0.09629639015242705,0
1976-06-01,78988,78900,78943,19,-88,-45,-0.057003154174530994,0
1976-07-01,79121,79192,79176,20,71,55,0.06946549459432151,0
1976-08-01,79431,79317,79333,19,-114,-98,-0.12352993079802857,0
1976-09-01,79561,79567,79572,18,6,11,0.0138239581762429,0
1976-10-01,79513,79451,79467,19,-62,-46,-0.05788566323127839,0
1976-11-01,79711,79700,80106,17,-11,395,0.4930966469428008,0
1976-12-01,79957,80322,80344,18,365,387,0.48167878124066515,0
1977-01-01,80553,80559,80561,19,6,8,0.009930363327168233,0
1977-02-01,80818,80816,80824,19,-2,6,0.007423537563100069,0
1977-03-01,81304,81372,81395,19,68,91,0.11180047914491062,0
1977-04-01,81644,81605,81686,20,-39,42,0.05141639938300321,0
1977-05-01,81792,81921,81837,19,129,45,0.05498735290883097,0
1977-06-01,82056,82095,82121,18,39,65,0.0791514959632737,0
1977-07-01,82351,82356,82366,19,5,15,0.018211397906903334,0
1977-08-01,82448,82459,82480,19,11,32,0.038797284190106696,0
1977-09-01,82750,82807,82763,17,57,13,0.015707502144678177,0
1977-10-01,82926,82905,82902,18,-21,-24,-0.02894984439458638,0
1977-11-01,83217,83222,83245,17,5,28,0.0336356537930206,0
1977-12-01,83439,83432,83429,19,-7,-10,-0.011986239796713373,0
1978-01-01,83685,83725,83719,18,40,34,0.04061204744442719,0
1978-02-01,84074,84055,84046,19,-19,-28,-0.03331508935582895,0
1978-03-01,84498,84537,84555,20,39,57,0.06741174383537342,0
1978-04-01,85156,85170,85223,19,14,67,0.07861727467937059,0
1978-05-01,85345,85454,85466,19,109,121,0.14157676736948027,0
1978-06-01,85729,85767,85820,19,38,91,0.10603588907014681,0
1978-07-01,86031,86003,86033,19,-28,2,0.002324689363383818,0
1978-08-01,86116,86164,86149,18,48,33,0.038305726125666,0
1978-09-01,86106,86167,86163,18,61,57,0.06615368545663451,0
1978-10-01,86597,86567,86573,19,-30,-24,-0.027722269067723192,0
1978-11-01,87034,87020,87036,17,-14,2,0.0022978997196562343,0
1978-12-01,87270,87248,87281,20,-22,11,0.012602972009944891,0
1979-01-01,87573,87465,87524,20,-108,-49,-0.05598464421187332,0
1979-02-01,87766,87832,87818,19,66,52,0.059213373112573735,0
1979-03-01,88156,88240,88263,19,84,107,0.12122860088598847,0
1979-04-01,88312,88267,88248,19,-45,-64,-0.07252289003716798,0
1979-05-01,88438,88516,88539,20,78,101,0.11407402387648381,0
1979-06-01,88613,88709,88764,20,96,151,0.17011401018430897,0
1979-07-01,88753,88813,89713,19,60,960,1.070079029795013,0
1979-08-01,88815,89718,89762,19,903,947,1.0550121432231903,0
1979-09-01,89853,89845,89803,19,-8,-50,-0.055677427257441285,0
1979-10-01,90151,89967,89982,19,-184,-169,-0.18781534084594698,0
1979-11-01,90185,90109,90100,19,-76,-85,-0.09433962264150944,0
1979-12-01,90426,90231,90241,19,-195,-185,-0.20500659345530303,0
1980-01-01,90536,90590,90652,20,54,116,0.12796187618585358,0
1980-02-01,90731,90774,90845,21,43,114,0.1254884693709065,1
1980-03-01,90634,90799,90819,19,165,185,0.20370186855173478,1
1980-04-01,90320,90508,90951,20,188,631,0.693780167342855,1
1980-05-01,90328,90602,90468,20,274,140,0.1547508511296812,1
1980-06-01,90088,89973,90047,20,-115,-41,-0.04553177784934534,1
1980-07-01,89735,89865,89867,19,130,132,0.14688372817608245,1
1980-08-01,90066,90109,90142,19,43,76,0.08431141975993432,0
1980-09-01,90296,90365,90384,19,69,88,0.09736236502035758,0
1980-10-01,90622,90612,90710,19,-10,88,0.09701245728144636,0
1980-11-01,90880,90917,90961,20,37,81,0.08904915293367487,0
1980-12-01,91122,91116,91125,18,-6,3,0.0032921810699588477,0
1981-01-01,91490,91499,91481,21,9,-9,-0.009838108459680152,0
1981-02-01,91550,91644,91652,21,94,102,0.11129053375812857,0
1981-03-01,91645,91714,91705,21,69,60,0.06542718499536558,0
1981-04-01,91494,91490,91458,20,-4,-36,-0.0393623302499508,0
1981-05-01,91474,91530,91564,20,56,90,0.0982919051155476,0
1981-06-01,91516,91583,91615,19,67,99,0.1080609070567047,0
1981-07-01,91966,91880,91880,19,-86,-86,-0.09360034828036569,0
1981-08-01,92027,91929,91901,19,-98,-126,-0.1371040576272293,1
1981-09-01,91875,91948,92033,20,73,158,0.17167755044386251,1
1981-10-01,91743,91798,91832,18,55,89,0.09691610767488457,1
1981-11-01,91561,91499,91522,19,-62,-39,-0.042612705141933084,1
1981-12-01,91206,91096,91113,19,-110,-93,-0.1020710546244773,1
1982-01-01,90859,90839,90879,19,-20,20,0.022007284411140086,1
1982-02-01,90936,91040,91019,21,104,83,0.0911897515903273,1
1982-03-01,90822,90760,90304,19,-62,-518,-0.5736180014174345,1
1982-04-01,90593,89993,90083,19,-600,-510,-0.5661445555765239,1
1982-05-01,89969,90151,90166,18,182,197,0.2184859037774771,1
1982-06-01,90010,89860,89839,20,-150,-171,-0.19034049800198133,1
1982-07-01,89843,89662,89535,19,-181,-308,-0.34399955324733344,1
1982-08-01,89451,89268,89312,21,-183,-139,-0.15563418129702616,1
1982-09-01,89038,89188,89267,20,150,229,0.2565337694780826,1
1982-10-01,88925,88878,88860,20,-47,-65,-0.07314877335133918,1
1982-11-01,88715,88684,88750,20,-31,35,0.03943661971830986,1
1982-12-01,88518,88535,88565,19,17,47,0.05306836786540959,0
1983-01-01,88874,88895,88920,21,21,46,0.051731893837157,0
1983-02-01,88715,88735,88759,21,20,44,0.04957243772462511,0
1983-03-01,88854,88955,88814,19,101,-40,-0.04503794446821447,0
1983-04-01,89213,89087,89101,21,-126,-112,-0.12570004825983996,0
1983-05-01,89461,89416,89421,17,-45,-40,-0.04473222173762315,0
1983-06-01,89760,89832,89844,19,72,84,0.09349539201282223,0
1983-07-01,90319,90202,90152,19,-117,-167,-0.18524270121572456,0
1983-08-01,89791,89735,89748,19,-56,-43,-0.04791193118509605,0
1983-09-01,90468,90753,90851,17,285,383,0.42156938283563195,0
1983-10-01,91073,91055,91087,21,-18,14,0.01536992106447682,0
1983-11-01,91425,91413,91355,19,-12,-70,-0.07662415850254502,0
1983-12-01,91644,91583,91599,19,-61,-45,-0.04912717387744408,0
1984-01-01,91870,91863,91930,19,-7,60,0.0652670510170782,0
1984-02-01,92249,92347,92357,21,98,108,0.1169375358662581,0
1984-03-01,92490,92506,93058,18,16,568,0.610372026048271,0
1984-04-01,92913,93456,93449,19,543,536,0.5735748911170799,0
1984-05-01,93688,93718,93768,21,30,80,0.08531695247845747,0
1984-06-01,94019,94076,94135,19,57,116,0.12322727997025548,0
1984-07-01,94378,94351,94350,19,-27,-28,-0.0296767355590885,0
1984-08-01,94510,94532,94523,19,22,13,0.013753266400770183,0
1984-09-01,94671,94754,94807,19,83,136,0.14344932336219898,0
1984-10-01,95195,95150,95154,21,-45,-41,-0.04308804674527608,0
1984-11-01,95453,95489,95494,19,36,41,0.042934634636731105,0
1984-12-01,95798,95661,95681,19,-137,-117,-0.12228133067171121,0
1985-01-01,96009,95993,96045,19,-16,36,0.03748243011088552,0
1985-02-01,96112,96157,96161,20,45,49,0.05095620885806096,0
1985-03-01,96538,96514,96910,18,-24,372,0.38386131462181405,0
1985-04-01,96731,97118,97120,20,387,389,0.4005354200988468,0
1985-05-01,97463,97386,97421,19,-77,-42,-0.043111854733579,0
1985-06-01,97466,97449,97473,18,-17,7,0.007181475895889118,0
1985-07-01,97692,97722,97707,19,30,15,0.01535202186127913,0
1985-08-01,98010,97987,97977,19,-23,-33,-0.033681374200067365,0
1985-09-01,98115,98217,98128,18,102,13,0.013248002608837437,0
1985-10-01,98529,98571,98559,18,42,30,0.030438620521717957,0
1985-11-01,98753,98739,98801,19,-14,48,0.048582504225665735,0
1985-12-01,99059,99069,99086,18,10,27,0.02724905637526997,0
1986-01-01,99635,99507,99496,20,-128,-139,-0.13970410870788774,0
1986-02-01,99733,99649,99656,21,-84,-77,-0.07726579433250381,0
1986-03-01,99841,99834,99484,20,-7,-357,-0.3588516746411483,0
1986-04-01,100040,99797,99783,19,-243,-257,-0.2575589028191175,0
1986-05-01,99946,99908,99918,18,-38,-28,-0.028022978842650974,0
1986-06-01,99819,99864,99843,18,45,24,0.02403773925062348,0
1986-07-01,100253,100122,100105,18,-131,-148,-0.14784476299885121,0
1986-08-01,100324,100261,100283,20,-63,-41,-0.040884297438249756,0
1986-09-01,100368,100448,100560,19,80,192,0.1909307875894988,0
1986-10-01,100746,100820,100826,20,74,80,0.07934461349255152,0
1986-11-01,101069,101065,101068,19,-4,-1,-0.000989432857086318,0
1986-12-01,101334,101293,101322,19,-41,-12,-0.01184342985728667,0
1987-01-01,101741,101641,101626,20,-100,-115,-0.1131600181056029,0
1987-02-01,101978,101862,101854,20,-116,-124,-0.12174288687729495,0
1987-03-01,102026,102009,101329,18,-17,-697,-0.6878583623641801,0
1987-04-01,102325,101609,101598,19,-716,-727,-0.7155652670328156,0
1987-05-01,101732,101672,101708,17,-60,-24,-0.023596963857317025,0
1987-06-01,101788,101811,101818,18,23,30,0.02946433832917559,0
1987-07-01,102115,102114,102126,18,-1,11,0.01077100836221922,0
1987-08-01,102270,102278,102275,19,8,5,0.0048887802493277925,0
1987-09-01,102410,102396,102434,20,-14,24,0.02342972060058184,0
1987-10-01,102945,102970,102983,19,25,38,0.036899294058242625,0
1987-11-01,103244,103246,103285,19,2,41,0.03969598683255071,0
1987-12-01,103572,103596,103612,19,24,40,0.03860556692275026,0
1988-01-01,103703,103786,103827,22,83,124,0.11942943550328912,0
1988-02-01,104317,104344,104365,22,27,48,0.04599243041249461,0
1988-03-01,104606,104661,105020,20,55,414,0.3942106265473243,0
1988-04-01,104835,105269,105281,20,434,446,0.42362819502094395,0
1988-05-01,105478,105502,105489,20,24,11,0.010427627525144801,0
1988-06-01,105848,106021,106057,19,173,209,0.1970638430278058,0
1988-07-01,106304,106257,106271,19,-47,-33,-0.03105268605734396,0
1988-08-01,106476,106440,106425,19,-36,-51,-0.04792107117688513,0
1988-09-01,106695,106729,106737,20,34,42,0.03934905421737542,0
1988-10-01,107052,106975,106973,19,-77,-79,-0.07385041085133631,0
1988-11-01,107438,107377,107419,19,-61,-19,-0.01768774611567786,0
1988-12-01,107656,107640,107641,19,-16,-15,-0.013935210561031577,0
1989-01-01,108048,108056,108065,20,8,17,0.015731272845046964,0
1989-02-01,108345,108341,107711,18,-4,-634,-0.5886121194678352,0
1989-03-01,108525,108512,107888,19,-13,-637,-0.5904271095951357,0
1989-04-01,108629,108094,108101,18,-535,-528,-0.48843211441152257,0
1989-05-01,108195,108308,108310,18,113,115,0.10617671498476595,0
1989-06-01,108488,108560,108607,19,72,119,0.1095693647739096,0
1989-07-01,108729,108791,108767,17,62,38,0.03493706730901836,0
1989-08-01,108901,108855,108887,18,-46,-14,-0.01285736589308182,0
1989-09-01,109064,109088,109096,19,24,32,0.029331964508322945,0
1989-10-01,109321,109189,109171,18,-132,-150,-0.13739912614155775,0
1989-11-01,109399,109393,109452,18,-6,53,0.048423053027811275,0
1989-12-01,109535,109548,109570,18,13,35,0.03194305010495574,0
1990-01-01,109823,109902,109931,29,79,108,0.098243443614631,0
1990-02-01,110274,110287,110304,25,13,30,0.027197563098346388,0
1990-03-01,110313,110407,110427,27,94,114,0.10323562172294819,0
1990-04-01,110471,110404,110401,26,-67,-70,-0.06340522277877918,0
1990-05-01,110568,110757,110770,27,189,202,0.18235984472330052,0
1990-06-01,110797,110925,110829,25,128,32,0.02887330933239495,0
1990-07-01,110706,110740,110269,25,34,-437,-0.39630358486972767,0
1990-08-01,110665,110657,110613,27,-8,-52,-0.04701074918861255,1
1990-09-01,110556,110561,110612,25,5,56,0.050627418363287886,1
1990-10-01,110493,110434,110432,25,-59,-61,-0.05523761228629383,1
1990-11-01,110167,110173,110165,26,6,-2,-0.0018154586302364635,1
1990-12-01,110097,110017,110004,24,-80,-93,-0.08454238027708083,1
1991-01-01,109785,109771,109813,27,-14,28,0.025497891870725688,1
1991-02-01,109587,109522,109527,25,-65,-60,-0.05478101290092854,1
1991-03-01,109316,109286,108902,25,-30,-414,-0.3801583074691007,1
1991-04-01,109162,108722,108736,26,-440,-426,-0.39177457327839904,0
1991-05-01,108781,108855,108887,24,74,106,0.09734862747619091,0
1991-06-01,108805,108866,108885,23,61,80,0.07347201175552188,0
1991-07-01,108815,108812,108859,21,-3,44,0.040419257939169013,0
1991-08-01,108846,108936,108971,24,90,125,0.11470941810206385,0
1991-09-01,108960,109019,109066,25,59,106,0.09718885812260467,0
1991-10-01,109018,109070,109073,26,52,55,0.05042494476176505,0
1991-11-01,108829,108808,108843,25,-21,14,0.012862563508907325,0
1991-12-01,108839,108846,108882,26,7,43,0.0394922944104627,0
1992-01-01,108755,108733,108760,25,-22,5,0.004597278411180581,0
1992-02-01,108897,108867,108866,24,-30,-31,-0.028475373394815644,0
1992-03-01,108886,108905,108200,24,19,-686,-0.634011090573013,0
1992-04-01,109031,108382,108377,23,-649,-654,-0.6034490712974155,0
1992-05-01,108450,108470,108496,25,20,46,0.04239787641940717,0
1992-06-01,108353,108433,108423,23,80,70,0.0645619471883272,0
1992-07-01,108631,108600,108594,22,-31,-37,-0.03407186400721955,0
1992-08-01,108517,108466,108485,23,-51,-32,-0.029497165506752087,0
1992-09-01,108409,108413,108497,23,4,88,0.08110823340737532,0
1992-10-01,108440,108531,108571,26,91,131,0.12065837101988561,0
1992-11-01,108636,108647,108646,22,11,10,0.00920420448060674,0
1992-12-01,108711,108736,108752,26,25,41,0.03770045608356628,0
1993-01-01,108842,108796,108865,23,-46,23,0.021127084003123135,0
1993-02-01,109161,109232,109203,23,71,42,0.0384604818548941,0
1993-03-01,109210,109194,109565,22,-16,355,0.3240085793821019,0
1993-04-01,109313,109781,109820,22,468,507,0.46166454197778184,0
1993-05-01,109990,110035,110058,22,45,68,0.06178560395427865,0
1993-06-01,110048,110102,110101,24,54,53,0.048137619095194414,0
1993-07-01,110264,110312,110338,26,48,74,0.06706664974895321,0
1993-08-01,110273,110297,110305,23,24,32,0.029010470966864602,0
1993-09-01,110453,110467,110502,25,14,49,0.04434308881287217,0
1993-10-01,110644,110649,110664,23,5,20,0.018072724643967326,0
1993-11-01,110857,110866,110880,26,9,23,0.020743145743145744,0
1993-12-01,111049,111070,111110,25,21,61,0.05490054900549005,0
1994-01-01,111132,111108,111079,24,-24,-53,-0.04771378928510339,0
1994-02-01,111325,111277,111357,23,-48,32,0.028736406332785545,0
1994-03-01,111733,111821,112298,23,88,565,0.5031256122103689,0
1994-04-01,112088,112656,112699,23,568,611,0.5421521042777664,0
1994-05-01,112847,112951,112951,22,104,104,0.09207532469832051,0
1994-06-01,113330,113307,113334,24,-23,4,0.0035293910035823317,0
1994-07-01,113566,113585,113624,25,19,58,0.05104555375624868,0
1994-08-01,113764,113870,113914,25,106,150,0.1316782836174658,0
1994-09-01,114109,114162,114186,25,53,77,0.06743383602192914,0
1994-10-01,114356,114350,114348,26,-6,-8,-0.006996187078042467,0
1994-11-01,114700,114836,114882,23,136,182,0.15842342577601365,0
1994-12-01,115092,115113,115113,25,21,21,0.018242943889916863,0
1995-01-01,115226,115289,115282,26,63,56,0.04857653406429451,0
1995-02-01,115607,115627,115637,24,20,30,0.025943253456938525,0
1995-03-01,115830,115814,116302,21,-16,472,0.40583996835823977,0
1995-04-01,115805,116295,116310,19,490,505,0.43418450692115895,0
1995-05-01,116194,116264,116248,24,70,54,0.04645241208450898,0
1995-06-01,116479,116498,116547,23,19,68,0.058345560160278684,0
1995-07-01,116553,116575,117201,22,22,648,0.552896306345509,0
1995-08-01,116802,116837,116838,24,35,36,0.030811893390848867,0
1995-09-01,116958,116888,116932,24,-70,-26,-0.022235145212602198,0
1995-10-01,117004,116998,117000,24,-6,-4,-0.003418803418803419,0
1995-11-01,117164,117212,117899,21,48,735,0.6234149568698631,0
1995-12-01,117315,117373,117357,22,58,42,0.0357882358956006,0
1996-01-01,117172,117169,117211,24,-3,39,0.033273327588707546,0
1996-02-01,117874,117835,117842,26,-39,-32,-0.02715500415811001,0
1996-03-01,117975,118020,118737,24,45,762,0.6417544657520402,0
1996-04-01,118022,118900,118928,22,878,906,0.7618054621283465,0
1996-05-01,119248,119293,119335,26,45,87,0.07290400972053462,0
1996-06-01,119532,119555,119554,21,23,22,0.018401726416514712,0
1996-07-01,119748,119782,119772,22,34,24,0.020038072337441138,0
1996-08-01,120032,120029,120052,23,-3,20,0.016659447572718488,0
1996-09-01,119989,120017,120050,21,28,61,0.05081216159933361,0
1996-10-01,120227,120274,120311,22,47,84,0.06981905228948308,0
1996-11-01,120392,120438,120492,24,46,100,0.08299306178003518,0
1996-12-01,120700,120753,120723,24,53,23,0.019051879095118577,0
1997-01-01,121024,120970,120982,23,-54,-42,-0.03471590815162586,0
1997-02-01,121309,121275,121296,21,-34,-13,-0.010717583432264872,0
1997-03-01,121450,121435,121344,21,-15,-106,-0.08735495780590717,0
1997-04-01,121577,121667,121671,22,90,94,0.07725752233482096,0
1997-05-01,121805,121837,121834,22,32,29,0.0238028793276097,0
1997-06-01,122054,122062,122056,20,8,2,0.0016385921216490792,0
1997-07-01,122378,122421,122440,22,43,62,0.050637046716759226,0
1997-08-01,122470,122480,122492,21,10,22,0.01796035659471639,0
1997-09-01,122695,122761,122792,23,66,97,0.07899537429148479,0
1997-10-01,123045,123079,123083,23,34,38,0.030873475622141155,0
1997-11-01,123483,123495,123512,24,12,29,0.023479499967614482,0
1997-12-01,123865,123867,123866,21,2,1,0.0008073240437246703,0
1998-01-01,124225,124241,124265,23,16,40,0.03218927292479781,0
1998-02-01,124551,124517,124524,24,-34,-27,-0.02168256721595837,0
1998-03-01,124481,124500,124914,20,19,433,0.3466384872792481,0
1998-04-01,124762,125216,125234,24,454,472,0.3768944535828928,0
1998-05-01,125512,125543,125562,22,31,50,0.03982096494162247,0
1998-06-01,125748,125758,125751,21,10,3,0.0023856669131855812,0
1998-07-01,125824,125819,125869,22,-5,45,0.03575145587873106,0
1998-08-01,126184,126178,126191,19,-6,7,0.005547146785428438,0
1998-09-01,126247,126348,126363,23,101,116,0.09179902344831953,0
1998-10-01,126464,126508,126527,23,44,63,0.049791744054628655,0
1998-11-01,126775,126778,126804,24,3,29,0.022869941011324564,0
1998-12-01,127156,127102,127118,20,-54,-38,-0.029893484793656288,0
1999-01-01,127347,127335,127378,22,-12,31,0.024337012670947886,0
1999-02-01,127610,127632,127670,21,22,60,0.04699616198010496,0
1999-03-01,127678,127677,127813,21,-1,135,0.10562305868730097,0
1999-04-01,127911,128156,128134,24,245,223,0.17403655548098085,0
1999-05-01,128167,128129,128162,21,-38,-5,-0.003901312401491862,0
1999-06-01,128397,128435,128443,23,38,46,0.035813551536479214,0
1999-07-01,128745,128781,128816,24,36,71,0.0551173767233884,0
1999-08-01,128905,128919,128945,22,14,40,0.031020977936329443,0
1999-09-01,128911,128986,129048,22,75,137,0.10616204823011592,0
1999-10-01,129296,129311,129332,22,15,36,0.02783533850864442,0
1999-11-01,129545,129554,129589,21,9,44,0.033953499139587465,0
1999-12-01,129869,129905,129898,24,36,29,0.022325209010146424,0
2000-01-01,130292,130282,130292,23,-10,0,0.0,0
2000-02-01,130325,130299,130319,24,-26,-6,-0.004604086894466655,0
2000-03-01,130715,130777,131009,21,62,294,0.22441206329336152,0
2000-04-01,131117,131423,131419,22,306,302,0.2297993440826669,0
2000-05-01,131654,131590,131909,22,-64,255,0.19331508843217673,0
2000-06-01,131601,131620,131647,22,19,46,0.034941928034820394,0
2000-07-01,131512,131596,131607,22,84,95,0.0721846102410966,0
2000-08-01,131491,131516,131528,23,25,37,0.028130892281491394,0
2000-09-01,131768,131723,132046,23,-45,278,0.2105326931523863,0
2000-10-01,131860,131800,131789,23,-60,-71,-0.053873995553498394,0
2000-11-01,131894,131848,131842,23,-46,-52,-0.039441149254410585,0
2000-12-01,131953,131861,131878,23,-92,-75,-0.056870744172644414,0
2001-01-01,132129,132102,132167,25,-27,38,0.02875150377930951,0
2001-02-01,132237,132307,132303,26,70,66,0.04988549012494048,0
2001-03-01,132221,132250,132654,24,29,433,0.3264130746151643,0
2001-04-01,132027,132472,132489,22,445,462,0.3487081946425741,1
2001-05-01,132453,132497,132530,23,44,77,0.05810005281822984,1
2001-06-01,132383,132437,132431,21,54,48,0.03624529000007551,1
2001-07-01,132395,132444,132449,24,49,54,0.04077040974261791,1
2001-08-01,132331,132365,132395,24,34,64,0.048340194116092,1
2001-09-01,132166,132182,132230,23,16,64,0.04840051425546396,1
2001-10-01,131767,131762,131782,21,-5,15,0.011382434626883793,1
2001-11-01,131431,131411,131427,23,-20,-4,-0.0030435146507186497,1
2001-12-01,131287,131297,131321,24,10,34,0.025890756238530013,0
2002-01-01,131208,131195,131212,23,-13,4,0.0030485016614334053,0
2002-02-01,131261,131210,131208,23,-51,-53,-0.04039387842204743,0
2002-03-01,131268,131187,130701,22,-81,-567,-0.4338145844331719,0
2002-04-01,131230,130707,130680,22,-523,-550,-0.4208754208754209,0
2002-05-01,130748,130704,130702,21,-44,-46,-0.03519456473504613,0
2002-06-01,130740,130768,130736,24,28,-4,-0.0030596010280259456,0
2002-07-01,130774,130803,130790,23,29,16,0.012233351173637129,0
2002-08-01,130842,130897,130913,22,55,71,0.054234491608931124,0
2002-09-01,130854,130900,130909,24,46,55,0.04201391806522088,0
2002-10-01,130895,130915,130898,23,20,3,0.002291860838209904,0
2002-11-01,130875,130810,130817,23,-65,-58,-0.04433674522424456,0
2002-12-01,130709,130661,130670,23,-48,-39,-0.029846177393433843,0
2003-01-01,130804,130855,130873,24,51,69,0.05272286873533884,0
2003-02-01,130547,130516,130520,22,-31,-27,-0.020686484829911124,0
2003-03-01,130408,130396,130084,22,-12,-324,-0.24906983180099013,0
2003-04-01,130348,130084,130062,18,-264,-286,-0.21989512693945965,0
2003-05-01,130067,129992,129986,22,-75,-81,-0.06231440308956349,0
2003-06-01,129962,129914,129903,21,-48,-59,-0.04541850457649169,0
2003-07-01,129870,129854,129846,21,-16,-24,-0.018483434222078463,0
2003-08-01,129761,129805,129881,21,44,120,0.09239226676727158,0
2003-09-01,129862,130006,129980,21,144,118,0.09078319741498692,0
2003-10-01,130132,130117,130080,21,-15,-52,-0.03997539975399754,0
2003-11-01,130174,130123,130027,20,-51,-147,-0.1130534427465065,0
2003-12-01,130124,130043,130035,20,-81,-89,-0.06844311146998885,0
2004-01-01,130155,130132,130194,22,-23,39,0.029955297479146506,0
2004-02-01,130153,130240,130277,21,87,124,0.09518180492335562,0
2004-03-01,130548,130614,130630,20,66,82,0.0627727168338054,0
2004-04-01,130902,130976,130954,21,74,52,0.039708599966400415,0
2004-05-01,131224,131189,131162,19,-35,-62,-0.047269788505817235,0
2004-06-01,131301,131240,131258,20,-61,-43,-0.03275990796751436,0
2004-07-01,131272,131331,131343,23,59,71,0.05405693489565489,0
2004-08-01,131475,131471,131541,20,-4,66,0.05017447031723949,0
2004-09-01,131567,131680,131660,23,113,93,0.07063648792343916,0
2004-10-01,132017,131963,131972,22,-54,-45,-0.0340981420301276,0
2004-11-01,132075,132109,132294,20,34,219,0.1655403873191528,0
2004-12-01,132266,132427,132449,21,161,183,0.13816638857220515,0
2005-01-01,132573,132581,132573,22,8,0,0.0,0
2005-02-01,132843,132816,132873,20,-27,30,0.022577950373665077,0
2005-03-01,132926,133019,132995,21,93,69,0.051881649686078425,0
2005-04-01,133293,133269,133287,22,-24,-6,-0.0045015642935920235,0
2005-05-01,133347,133391,133413,20,44,66,0.049470441411256776,0
2005-06-01,133537,133579,133588,21,42,51,0.038177081773812016,0
2005-07-01,133786,133830,133865,22,44,79,0.05901467896761663,0
2005-08-01,133999,134076,134013,20,77,14,0.010446747703580997,0
2005-09-01,134041,134005,134030,22,-36,-11,-0.008207117809445646,0
2005-10-01,134061,134074,134055,20,13,-6,-0.004475774868524113,0
2005-11-01,134289,134360,134231,20,71,-58,-0.04320909476946458,0
2005-12-01,134468,134371,134376,20,-97,-92,-0.06846460677501935,0
2006-01-01,134564,134546,134530,21,-18,-34,-0.025273173269902624,0
2006-02-01,134789,134755,134730,23,-34,-59,-0.04379128627625622,0
2006-03-01,134966,134930,134905,21,-36,-61,-0.045217004558763575,0
2006-04-01,135068,135031,135017,21,-37,-51,-0.037773021175111283,0
2006-05-01,135106,135109,135117,21,3,11,0.008141092534618146,0
2006-06-01,135230,135241,135251,22,11,21,0.015526687418207629,0
2006-07-01,135354,135372,135374,21,18,20,0.01477388567967261,0
2006-08-01,135500,135562,135604,21,62,104,0.07669390283472464,0
2006-09-01,135613,135752,135807,22,139,194,0.14284977946644872,0
2006-10-01,135844,135886,135893,23,42,49,0.03605778075397555,0
2006-11-01,136018,136047,136941,19,29,923,0.6740128960647286,0
2006-12-01,136214,137147,137167,21,933,953,0.6947735242441695,0
2007-01-01,137258,137313,137329,20,55,71,0.05170066045773289,0
2007-02-01,137410,137442,137419,21,32,9,0.006549312686018673,0
2007-03-01,137622,137596,137594,19,-26,-28,-0.02034972455194267,0
2007-04-01,137684,137674,137716,21,-10,32,0.023236225275204043,0
2007-05-01,137831,137906,137904,18,75,73,0.052935375333565376,0
2007-06-01,138038,138030,137973,20,-8,-65,-0.04711066657969313,0
2007-07-01,138122,138041,138066,19,-81,-56,-0.04056031173496733,0
2007-08-01,138037,138155,138159,21,118,122,0.08830405547231812,0
2007-09-01,138265,138255,138203,20,-10,-62,-0.04486154425012481,0
2007-10-01,138421,138373,138362,19,-48,-59,-0.04264176580274931,0
2007-11-01,138467,138477,138037,19,10,-430,-0.31151068191861603,0
2007-12-01,138495,138119,138078,19,-376,-417,-0.3020032155738061,0
2008-01-01,138102,138056,138002,20,-46,-100,-0.07246271793162418,1
2008-02-01,137993,137926,137919,20,-67,-74,-0.053654681370949614,1
2008-03-01,137846,137838,137831,19,-8,-15,-0.010882892818016266,1
2008-04-01,137818,137803,137764,19,-15,-54,-0.03919746813391017,1
2008-05-01,137754,137702,137717,18,-52,-37,-0.02686669038680773,1
2008-06-01,137640,137666,137617,18,26,-23,-0.016713051439865713,1
2008-07-01,137615,137557,137550,18,-58,-65,-0.04725554343874955,1
2008-08-01,137473,137477,137423,18,4,-50,-0.03638401141002598,1
2008-09-01,137318,137139,137020,19,-179,-298,-0.21748649832141292,1
2008-10-01,136899,136700,136597,19,-199,-302,-0.22108831087066333,1
2008-11-01,136167,136013,135755,18,-154,-412,-0.3034879009981216,1
2008-12-01,135489,135178,135074,19,-311,-415,-0.3072389949213024,1
2009-01-01,134580,134419,134333,18,-161,-247,-0.1838714239985707,1
2009-02-01,133768,133682,133652,17,-86,-116,-0.08679256576781492,1
2009-03-01,133019,132953,133000,19,-66,-19,-0.014285714285714285,1
2009-04-01,132414,132496,132481,18,82,67,0.050573289754757285,1
2009-05-01,132151,132159,132178,17,8,27,0.020426999954606666,1
2009-06-01,131692,131735,131715,19,43,23,0.017461944349542572,1
2009-07-01,131488,131439,131411,19,-49,-77,-0.05859479039045438,0
2009-08-01,131223,131210,131257,17,-13,34,0.025903380391141043,0
2009-09-01,130947,131038,131118,19,91,171,0.13041687640140942,0
2009-10-01,130848,131007,130991,19,159,143,0.10916780542174653,0
2009-11-01,130996,130995,129697,16,-1,-1299,-1.00156518655019,0
2009-12-01,130910,129547,129588,18,-1363,-1322,-1.0201561873012934,0
2010-01-01,129527,129562,129602,18,35,75,0.05786947732288082,0
2010-02-01,129526,129588,129641,17,62,115,0.08870650488657138,0
2010-03-01,129750,129871,129849,17,121,99,0.0762424046392348,0
2010-04-01,130161,130139,130162,16,-22,1,0.0007682733824003933,0
2010-05-01,130570,130595,130594,17,25,24,0.018377567116406573,0
2010-06-01,130470,130373,130419,17,-97,-51,-0.039104731672532374,0
2010-07-01,130242,130365,130353,17,123,111,0.08515339117626752,0
2010-08-01,130311,130296,130352,18,-15,41,0.03145329569166564,0
2010-09-01,130201,130311,130328,18,110,127,0.09744644282118961,0
2010-10-01,130462,130500,130538,17,38,76,0.0582205947693392,0
2010-11-01,130539,130609,130108,15,70,-431,-0.33126325821625113,0
2010-12-01,130712,130229,130260,17,-483,-452,-0.3469983110701674,0
2011-01-01,130265,130323,130328,16,58,63,0.04833957399791296,0
2011-02-01,130515,130522,130563,17,7,48,0.0367638611245146,0
2011-03-01,130738,130784,130757,17,46,19,0.014530770819153086,0
2011-04-01,131028,130989,130974,16,-39,-54,-0.04122955701131522,0
2011-05-01,131043,130999,131027,15,-44,-16,-0.012211223640928968,0
2011-06-01,131017,131073,131047,16,56,30,0.022892550001144627,0
2011-07-01,131190,131132,131174,17,-58,-16,-0.012197539146477199,0
2011-08-01,131132,131231,131278,17,99,146,0.11121436950593397,0
2011-09-01,131334,131436,131488,17,102,154,0.11712095400340715,0
2011-10-01,131516,131588,131600,15,72,84,0.06382978723404255,0
2011-11-01,131708,131700,131963,15,-8,255,0.19323598281336435,0
2011-12-01,131900,132166,132186,16,266,286,0.2163617932307506,0
2012-01-01,132409,132470,132461,16,61,52,0.03925683786171024,0
2012-02-01,132697,132701,132720,16,4,23,0.017329716696805303,0
2012-03-01,132821,132874,132863,15,53,42,0.031611509600114406,0
2012-04-01,132989,132940,132931,15,-49,-58,-0.04363165852961311,0
2012-05-01,133009,133008,133018,14,-1,9,0.0067660015937692644,0
2012-06-01,133088,133082,133063,15,-6,-25,-0.018788092858270142,0
2012-07-01,133245,133204,133244,15,-41,-1,-0.0007505028369007235,0
2012-08-01,133300,133386,133436,16,86,136,0.10192152042926947,0
2012-09-01,133500,133584,133568,15,84,68,0.05091039770004792,0
2012-10-01,133755,133706,133705,16,-49,-50,-0.037395759320893014,0
2012-11-01,133852,133866,134472,15,14,620,0.46106252602772324,0
2012-12-01,134021,134668,134691,14,647,670,0.4974348694419078,0
2013-01-01,134825,134810,134839,15,-15,14,0.010382752764407923,0
2013-02-01,135046,135107,135171,15,61,125,0.09247545701370856,0
2013-03-01,135195,135309,135313,15,114,118,0.08720522048879265,0
2013-04-01,135474,135462,135512,14,-12,38,0.02804179703642482,0
2013-05-01,135637,135707,135688,13,70,51,0.03758622722716821,0
2013-06-01,135902,135876,135860,14,-26,-42,-0.030914176358015605,0
2013-07-01,136038,135964,135949,13,-74,-89,-0.06546572611788244,0
2013-08-01,136133,136142,136187,15,9,54,0.039651361730561656,0
2013-09-01,136290,136350,136362,14,60,72,0.052800633607603294,0
2013-10-01,136554,136562,137037,13,8,483,0.3524595547187986,0
2013-11-01,136765,136803,137311,14,38,546,0.39763747988143705,0
2013-12-01,136877,137386,137395,14,509,518,0.37701517522471706,0
2014-01-01,137499,137524,137539,14,25,40,0.029082660190927666,0
2014-02-01,137699,137736,137761,14,37,62,0.04500548050609389,0
2014-03-01,137928,137964,138055,13,36,127,0.09199232190069176,0
2014-04-01,138252,138246,138268,13,-6,16,0.01157173026296757,0
2014-05-01,138463,138492,138497,14,29,34,0.024549268215195996,0
2014-06-01,138780,138795,138764,13,15,-16,-0.011530368107001816,0
2014-07-01,139004,138976,139007,13,-28,3,0.0021581646967418905,0
2014-08-01,139118,139187,139210,14,69,92,0.0660872063788521,0
2014-09-01,139435,139466,139481,14,31,46,0.03297940221248772,0
2014-10-01,139680,139724,139742,14,44,62,0.044367477207997594,0
2014-11-01,140045,140095,140263,13,50,218,0.15542231379622568,0
2014-12-01,140347,140592,140592,11,245,245,0.17426311596676908,0
2015-01-01,140849,140831,140793,11,-18,-56,-0.03977470470833067,0
2015-02-01,141126,141057,141059,12,-69,-67,-0.04749785550727001,0
2015-03-01,141183,141144,141178,12,-39,-5,-0.0035416282990267606,0
2015-04-01,141367,141399,141365,11,32,-2,-0.0014147773494146358,0
2015-05-01,141679,141619,141625,12,-60,-54,-0.0381288614298323,0
2015-06-01,141842,141856,141870,11,14,28,0.019736378374568268,0
2015-07-01,142071,142115,142093,11,44,22,0.015482817591295842,0
2015-08-01,142288,142229,142246,11,-59,-42,-0.029526313569450107,0
2015-09-01,142371,142383,142391,11,12,20,0.014045831548342241,0
2015-10-01,142654,142689,142698,12,35,44,0.030834349465304348,0
2015-11-01,142900,142950,142875,10,50,-25,-0.017497812773403325,0
2015-12-01,143242,143137,143146,10,-105,-96,-0.06706439579170917,0
2016-01-01,143288,143318,143314,12,30,26,0.018141981941750283,0
2016-02-01,143560,143559,143547,12,-1,-13,-0.009056267285279387,0
2016-03-01,143774,143755,143733,11,-19,-41,-0.028525112535047623,0
2016-04-01,143915,143856,143877,11,-59,-38,-0.02641144866795944,0
2016-05-01,143894,143888,143901,11,-6,7,0.0048644554242152594,0
2016-06-01,144175,144193,144172,11,18,-3,-0.0020808478761479344,0
2016-07-01,144448,144447,144424,11,-1,-24,-0.016617736664266327,0
2016-08-01,144598,144591,144600,10,-7,2,0.0013831258644536654,0
2016-09-01,144747,144791,144808,11,44,61,0.04212474448925474,0
2016-10-01,144952,144950,144943,11,-2,-9,-0.006209337463692624,0
2016-11-01,145128,145147,145170,11,19,42,0.028931597437487085,0
2016-12-01,145303,145327,145325,11,24,22,0.01513848271116463,0
2017-01-01,145554,145563,145541,12,9,-13,-0.008932190929016566,0
2017-02-01,145798,145760,145773,11,-38,-25,-0.01714995232313254,0
2017-03-01,145858,145852,145823,12,-6,-35,-0.024001700691934743,0
2017-04-01,146063,145997,146030,12,-66,-33,-0.022598096281585975,0
2017-05-01,146135,146182,146175,11,47,40,0.027364460407046348,0
2017-06-01,146404,146406,146385,11,2,-19,-0.012979471940431055,0
2017-07-01,146615,146574,146523,10,-41,-92,-0.06278877718856425,0
2017-08-01,146730,146692,146731,11,-38,1,0.0006815192426958175,0
2017-09-01,146659,146749,146769,11,90,110,0.074947706940839,0
2017-10-01,147010,147013,146980,12,3,-30,-0.020410940263981495,0
2017-11-01,147241,147232,147450,11,-9,209,0.14174296371651407,0
2017-12-01,147380,147610,147625,10,230,245,0.165961049957663,0
2018-01-01,147810,147864,147801,11,54,-9,-0.006089268678831672,0
2018-02-01,148177,148127,148125,10,-50,-52,-0.03510548523206751,0
2018-03-01,148230,148260,148280,10,30,50,0.03371998920960345,0
2018-04-01,148424,148439,148455,10,15,31,0.020881748678050586,0
2018-05-01,148662,148699,148723,10,37,61,0.04101584825480928,0
2018-06-01,148912,148971,148931,11,59,19,0.01275758572761883,0
2018-07-01,149128,149078,149096,11,-50,-32,-0.021462681762086173,0
2018-08-01,149279,149366,149382,11,87,103,0.06895074373083772,0
2018-09-01,149500,149501,149575,9,1,75,0.05014206919605549,0
2018-10-01,149750,149738,149775,11,-12,25,0.016691704223001168,0
2018-11-01,149893,149951,150048,9,58,155,0.10330027724461506,0
2018-12-01,150263,150270,150275,10,7,12,0.007985360173016137,0
2019-01-01,150574,150586,150587,10,12,13,0.008632883316620956,0
2019-02-01,150606,150620,150643,10,14,37,0.024561380216803968,0
2019-03-01,150816,150832,150796,10,16,-20,-0.013262951271917027,0
2019-04-01,151095,151020,151012,10,-75,-83,-0.0549625195348714,0
2019-05-01,151095,151084,151074,10,-11,-21,-0.013900472616068946,0
2019-06-01,151308,151267,151252,10,-41,-56,-0.0370243038108587,0
2019-07-01,151431,151411,151418,10,-20,-13,-0.008585505025822558,0
2019-08-01,151541,151586,151637,10,45,96,0.06330908683236941,0
2019-09-01,151722,151817,151830,10,95,108,0.07113218731475993,0
2019-10-01,151945,151986,151982,10,41,37,0.02434498822228948,0
2019-11-01,152252,152238,151814,9,-14,-438,-0.2885109410199323,0
2019-12-01,152383,151961,151998,9,-422,-385,-0.25329280648429586,0
2020-01-01,152186,152271,152212,9,85,26,0.017081439045541744,0
2020-02-01,152544,152487,152442,10,-57,-102,-0.066910693903255,0
2020-03-01,151786,151572,151582,10,-214,-204,-0.13458062302911955,1
2020-04-01,131072,131045,130403,10,-27,-669,-0.513025007093395,1
2020-05-01,132912,133002,133028,8,90,116,0.08719968728388008,0
2020-06-01,137802,137819,137809,9,17,7,0.005079494082389394,0
2020-07-01,139582,139543,139570,9,-39,-12,-0.008597836211220176,0
2020-08-01,140914,141059,141063,9,145,149,0.10562656401749573,0
2020-09-01,141720,141735,141774,9,15,54,0.03808878919971222,0
2020-10-01,142373,142384,142428,9,11,55,0.03861600247142416,0
2020-11-01,142629,142764,142809,8,135,180,0.12604247631451798,0
2020-12-01,142624,142582,142503,8,-42,-121,-0.0849104931124257,0
2021-01-01,142631,142669,142736,8,38,105,0.07356238089900236,0
2021-02-01,143048,143204,143272,8,156,224,0.1563459712993467,0
2021-03-01,144120,144042,144057,8,-78,-63,-0.043732689143880545,0
2021-04-01,144308,144335,144326,8,27,18,0.012471765309091916,0
2021-05-01,144894,144909,144940,8,15,46,0.031737270594728854,0
2021-06-01,145759,145878,145902,8,119,143,0.09801099368068977,0
2021-07-01,146821,146955,146993,7,134,172,0.11701237473893315,0
2021-08-01,147190,147359,147476,7,169,286,0.1939298597737937,0
2021-09-01,147553,147788,147855,7,235,302,0.204254167934801,0
2021-10-01,148319,148401,148503,7,82,184,0.123903220810354,0
2021-11-01,148611,148752,148652,6,141,41,0.027581196351209536,0
2021-12-01,148951,149162,149240,6,211,289,0.1936478155990351,0
2022-01-01,149629,149721,149744,6,92,115,0.07679773480072657,0
2022-02-01,150399,150494,150458,6,95,59,0.03921360113785907,0
2022-03-01,150925,150886,150856,6,-39,-69,-0.045738982871082356,0
2022-04-01,151314,151292,151224,6,-22,-90,-0.059514362799555624,0
2022-05-01,151682,151608,151610,6,-74,-72,-0.04749027109029747,0
2022-06-01,151980,152008,151903,6,28,-77,-0.0506902431156725,0
2022-07-01,152536,152429,152440,6,-107,-96,-0.06297559695617948,0
2022-08-01,152744,152755,152732,6,11,-12,-0.007856899667391247,0
2022-09-01,153018,153047,153001,6,29,-17,-0.01111103848994451,0
2022-10-01,153308,153285,153264,6,-23,-44,-0.028708633469046875,0
2022-11-01,153548,153520,154296,5,-28,748,0.4847824959817494,0
2022-12-01,153743,154556,154535,5,813,792,0.5125052577086097,0
2023-01-01,155073,155039,155007,5,-34,-66,-0.04257872225125317,0
2023-02-01,155350,155333,155255,5,-17,-95,-0.061189655727673826,0
2023-03-01,155569,155420,155472,5,-149,-97,-0.06239065555212514,0
2023-04-01,155673,155766,155689,5,93,16,0.010276898175208268,0
2023-05-01,156105,155995,155970,5,-110,-135,-0.08655510675129832,0
2023-06-01,156204,156155,156075,5,-49,-129,-0.0826525708793849,0
2023-07-01,156342,156232,156311,5,-110,-31,-0.0198322574866772,0
2023-08-01,156419,156538,156476,5,119,57,0.03642731153659347,0
2023-09-01,156874,156773,156738,5,-101,-136,-0.08676900304967525,0
2023-10-01,156923,156888,156843,5,-35,-80,-0.05100642043317202,0
2023-11-01,157087,157016,157014,4,-71,-73,-0.046492669443489114,0
2023-12-01,157232,157347,157304,4,115,72,0.04577124548644663,0
2024-01-01,157700,157533,157560,4,-167,-140,-0.08885503935008886,0
2024-02-01,157808,157830,157796,4,22,-12,-0.007604755507110446,0
2024-03-01,158133,158111,158106,4,-22,-27,-0.017077150772266708,0
2024-04-01,158286,158271,158214,4,-15,-72,-0.04550798285865979,0
2024-05-01,158543,158432,158430,4,-111,-113,-0.07132487533926656,0
2024-06-01,158638,158609,158548,4,-29,-90,-0.05676514367888589,0
2024-07-01,158723,158637,158692,4,-86,-31,-0.019534696140952285,0
2024-08-01,158779,158851,158770,4,72,-9,-0.005668577187126031,0
2024-09-01,159105,158993,159025,4,-112,-80,-0.05030655557302311,0
2024-10-01,159005,159061,159068,4,56,63,0.03960570322126386,0
2024-11-01,159288,159280,158619,3,-8,-669,-0.42176536228320693,0
2024-12-01,159536,158926,158942,3,-610,-594,-0.3737212316442476,0
2025-01-01,159069,159067,159053,3,-2,-16,-0.010059539901793741,0
2025-02-01,159218,159170,159155,3,-48,-63,-0.039584053281392355,0
2025-03-01,159398,159340,159275,3,-58,-123,-0.07722492544341547,0
2025-04-01,159517,159422,159433,3,-95,-84,-0.05268670852332955,0
2025-05-01,159561,159577,159452,3,16,-109,-0.0683591300203196,0
2025-06-01,159724,159466,159439,3,-258,-285,-0.17875174831753837,0
2025-07-01,159539,159518,,2,-21,,,0
2025-08-01,159540,,,1,,,,0
